#######
#@    #
# $# .#
#  #  #
#######