########
#       #
#@$     #
######  #
     #  #
######  #
#       #
# .     #
#       #
########