############
#$         #
#          #
#   @      #
#          #
#          #
#          #
#          #
#          #
# .        #
#          #
############