##########
#..      #
#..      #
#   @    #
#        #
#  $  $  #
#        #
#  $  $  #
#        #
##########