#####
#   # 
# @*#
#  *#
#####